r = 10; c = 30

TTTTTTTTTTTTTTTTTTTTTTTTTTTTTT
TL..........~~~.............OT
T...........~~~..............T
T....+......~~~.......+......T
T...........~~~..............T
TTTTTT......~~~.......TTTTTTTT
T...........~~~..............T
T..+........~~~..........+...T
T...........~~~..............T
TTTTTTTTTTTTTTTTTTTTTTTTTTTTTT