r = 14; c = 29

TTTTTTTTTTTTTTTTTTTTTTTTTTTTT
TL.R..........R..........R.OT
T.............R.............T
T.TTTT..~~~...R...~~~..TTTT.T
T.T.....~~~.......~~~.....T.T
T.T..+..~~~...+...~~~..+..T.T
T.TTTT..~~~.......~~~..TTTT.T
T.......~~~.......~~~.......T
TTTTTTTTTTTT.R.RTTTTTTTTTTTTT
T.........R.......R.........T
T..+......R...+...R......+..T
T.........R.......R.........T
T.........R.......R.........T
TTTTTTTTTTTTTTTTTTTTTTTTTTTTT