r = 12; c = 30

TTTTTTTTTTTTTTTTTTTTTTTTTTTTTT
TL............~.............OT
T.............T..............T
T....+........T.....+........T
T....TTTTTTTTTTTTTTTTTTTT....T
T....T...............*..T....T
T....T....~~~~~~~~~~~~~~T....T
T....T....~~~~~~~~~~~~~~T....T
T....T....~~~~~~~TTTTTTTT....T
T....T....~~~~~~~T+.....T....T
T....+....~~~~~~~~~~~~~~~~~~~T
TTTTTTTTTTTTTTTTTTTTTTTTTTTTTT

