r = 12; c = 29

TTTTTTTTTTTTTTTTTTTTTTTTTTTTT
TL............T............OT
T.............T.............T
T.TTTTTTTTTT.RTR.TTTTTTTTTT.T
T.T........T..T..T........T.T
T.T...+.....~~~~~.....+...T.T
T.T........T~~~~~T........T.T
T.TTTTTTTTTT~~~~~TTTTTTTTTT.T
T...........~~~~~...........T
T.TTTT..+...~~~~~.+..TTTTTT.T
T.TTTTTTTTTTTTTTTTTTTTTTTTT.T
TTTTTTTTTTTTTTTTTTTTTTTTTTTTT