r = 5; c = 10

TTTTTTTTTT
T.L.TT.O.T
T...TT...T
T.+.TT.+.T
TTTTTTTTTT