r = 11; c = 30

TTTTTTTTTTTTTTTTTTTTTTTTTTTTTT
TL..........................OT
T.TTTTTTTTT........TTTTTTTTT.T
T.T.......T........T.......T.T
T.T...+...T........T...+...T.T
T.T.......TTTT...TTTT......T.T
T.TTTTT................TTTTT.T
T.....T...TTTTTTTTTT...T.....T
T..+..T...T........T...T..+..T
T.....T...T........T...T.....T
TTTTTTTTTTTTTTTTTTTTTTTTTTTTTT