r = 13; c = 30

TTTTTTTTTTTTTTTTTTTTTTTTTTTTTT
TL..........................OT
T.TTTT~~~TTTT....TTTT~~~TTTT.T
T.T......~~~......~~~......T.T
T.T..+...~~~..+...~~~...+..T.T
T.TTTT...~~~......~~~...TTTT.T
T........~~~......~~~........T
T.TTTTTTTTTT......TTTTTTTTTT.T
T............~~~~............T
T.TTTT.......~~~~.......TTTT.T
T.T..+.......~~~~.......+..T.T
T.T..........~~~~..........T.T
TTTTTTTTTTTTTTTTTTTTTTTTTTTTTT