r = 12; c = 29

TTTTTTTTTTTTTTTTTTTTTTTTTTTTT
T....................~~~..x.T
T..R................R~~~....T
T..........TTTTT.....~~~~~~~T
T..........T.L.T.....~~~~~~~T
T..........T*O.T..........R.T
T..........TTTTT............T
T...........................T
TTTTTTTTTTTTTTTTTTTTTTTTTTTTT
T............T.x......+.....T
T.....+......T..............T
TTTTTTTTTTTTTTTTTTTTTTTTTTTTT
