r = 12; c = 29

TTTTTTTTTTTTTTTTTTTTTTTTTTTTT
TL.....+....TTTTT....+.....OT
T...............T..........xT
T.TTTTTTTTT.T...TTTTTTTTTTT.T
T.T.......T.T.............T.T
T.T...+...T.T...~~~~~...+.T.T
T.T.......T.T...~~~~~.....T.T
T.TTTTTTTTT.T...~~~~~.TTTTT.T
T...........T...~~~~~.......T
T.TTTTTTTTTTT...~~~~~TTTTTTTT
T....+.....T......T.........T
TTTTTTTTTTTTTTTTTTTTTTTTTTTTT
