r = 12; c = 29

TTTTTTTTTTTTTTTTTTTTTTTTTTTTT
TL...........R.............OT
T............R..............T
T...+...R....R........+.....T
T~~~~~~~~~~~TTTT............T
T~~~~~~~~~~~T..T............T
T~~~~~~~~~~~T++T............T
T........~~~T..T............T
T...*....~~~TTTT............T
T........~~~................T
T...+....~~~............+...T
TTTTTTTTTTTTTTTTTTTTTTTTTTTTT
