r = 11, c = 15
TTTTTTTTTTTTTTT
T.x...~.......T
T.TTT.~.+...+.T
T.TRT+~.......T
T.TTTT~.......T
T.....~.......T
T...+.~.......T
T.....~......RT
T.....~TTTTTT~T
TL..x.~T+..x..T
TTTTTTTTTTTTTTT
